111111111111
100010000001
101010111101
101000100101
101011100101
100000000101
111111100101
100000000101
101100000101
100100000101
100100000001
111111111111