11111111111111111111111
10001000000000000000001
10101011110000000000001
10100010010000000000001
10101110010000000000001
10000000010000000000001
11111110010000000000001
10000000010111111111111
10110000000000000000001
10010000010000000000001
10010000000000000000001
11111111111111111111111